推薦システム	すいせんしすてむ
情報過多	じょうほうかた
個人化	こじんか
非	ひ
一時的	いちじてき
永続的	えいぞくてき
適合アイテム発見	てきごうあいてむはっけん
評価値予測	ひょうかちよそく
適合アイテム列挙	てきごうあいてむれっきょ
効用最適化	こうようさいてきか
組み合わせ	くみあわせ
販売	はんばい
予測	よそく
精度	せいど
正解率	せいかいりつ
再現率	さいげんりつ
平均	へいきん
絶対誤差	ぜったいごさ
多様性	たようせい
被覆	ひふくりつ
学習	がくしゅうりつ
疎	そ
率	りつ
嗜好	しこう
活動	かつどう
利用者	りようしゃ
明示的	めいじてき
評価	ひょうか
格付け	かくづけ
法	ほう
暗黙的	あんもくてき
採点	さいてん
順位	じゅんい
